OXXXXXXXXXXXXXXXXXXXO
OXOOOOOOOOXOOOOOOOOXO
OXOXXOXXXOXOXXXOXXOXO
OXOOOOOOOOOOOOOOOOOXO
OXOXXOXOXXXXXOXOXXOXO
OXOOOOXOOOXOOOXOOOOXO
OOOOXOXXXOXOXXXOXXXXO
XXXXXOXOXXXXXOXOXXXXX
OOOOOOOOXOOOXOOOOOOOO
XXXXXOXOXXXXXOXOXXXXX
OOOOXOXXXOXOXXXOXXXXO
OXOOOOXOOOXOOOXOOOOXO
OXOXXOXOXXXXXOXOXXOXO
OXOOOOOOOOOOOOOOOOOXO
OXOXXOXXXOXOXXXOXXOXO
OXOOOOOOOOXOOOOOOOOXO
OXOOOOOOOOOOOOOOOOOXO
OXXXXXXXXXXXXXXXXXXXO